freebase:relation_1.tsv	concept:subpartoforganization	concept:agentbelongstoorganization concept:subpartof _concept:agenthierarchicallyaboveagent concept:relatedto concept:agentcollaborateswithagent _concept:agentcontrols concept:agentinteractswithagent	concept:televisionstationaffiliatedwith concept:teamplaysinleague _concept:acquired _concept:bankboughtbank
freebase:relation_2.tsv	concept:acquired	_concept:subpartoforganization _concept:agentbelongstoorganization _concept:subpartof concept:agenthierarchicallyaboveagent concept:relatedto concept:agentcollaborateswithagent concept:agentcontrols concept:agentinteractswithagent	concept:bankboughtbank
freebase:relation_3.tsv	concept:actorstarredinmovie	concept:agentcontributedtocreativework concept:relatedto
freebase:relation_4.tsv	concept:directordirectedmovie	concept:agentcontributedtocreativework concept:relatedto
freebase:relation_5.tsv	concept:athleteplayssport	concept:relatedto
freebase:relation_6.tsv	concept:buildinglocatedincity	concept:locationlocatedwithinlocation concept:subpartof concept:atlocation concept:relatedto	concept:airportincity concept:restaurantincity concept:museumincity concept:stadiumlocatedincity concept:hospitalincity concept:shoppingmallincity concept:hotelincity
freebase:relation_7.tsv	concept:ceoof	concept:topmemberoforganization concept:personleadsorganization concept:worksfor concept:agentleadsorganization concept:personbelongstoorganization concept:agentrepresentsorganization concept:agentcontrols concept:agentbelongstoorganization concept:proxyfor concept:relatedto concept:subpartof _concept:agenthierarchicallyaboveagent concept:mutualproxyfor concept:agentcollaborateswithagent _concept:agentcontrols concept:agentinteractswithagent _concept:organizationhastopmember	_concept:bankchiefexecutiveceo _concept:automobilemakerchiefexecutiveceo
freebase:relation_8.tsv	_concept:citycapitalofcountry	_concept:proxyfor _concept:citylocatedincountry concept:mutualproxyfor _concept:citylocatedingeopoliticallocation concept:relatedto _concept:locationlocatedwithinlocation _concept:subpartof _concept:atlocation
freebase:relation_9.tsv	concept:citylocatedincountry	concept:citylocatedingeopoliticallocation concept:locationlocatedwithinlocation concept:subpartof concept:atlocation concept:relatedto	concept:citycapitalofcountry
freebase:relation_10.tsv	concept:citylocatedinstate	concept:citylocatedingeopoliticallocation concept:locationlocatedwithinlocation concept:subpartof concept:atlocation concept:relatedto	_concept:statehascapital
freebase:relation_11.tsv	concept:companyeconomicsector	concept:relatedto
freebase:relation_12.tsv	concept:countrycurrency	concept:relatedto
freebase:relation_13.tsv	concept:hasofficeincity	concept:organizationactsinlocation concept:agentactsinlocation concept:agentrelatedtolocation concept:atlocation concept:relatedto	concept:televisionstationincity concept:radiostationincity concept:automobilemakerdealersincity concept:headquarteredin
freebase:relation_14.tsv	concept:hasofficeincountry	concept:organizationactsinlocation concept:agentactsinlocation concept:agentrelatedtolocation concept:atlocation concept:relatedto	concept:automobilemakerdealersincountry concept:bankbankincountry
freebase:relation_15.tsv	concept:headquarteredin	concept:hasofficeincity concept:organizationheadquarteredincity concept:organizationactsinlocation concept:agentactsinlocation concept:agentrelatedtolocation concept:atlocation concept:relatedto _concept:cityoforganizationheadquarters
freebase:relation_16.tsv	concept:leaguestadiums	concept:organizationactsinlocation concept:agentactsinlocation concept:agentrelatedtolocation concept:atlocation concept:relatedto
freebase:relation_17.tsv	concept:musicianplaysinstrument	concept:agentinvolvedwithitem concept:relatedto
freebase:relation_18.tsv	concept:musicartistgenre	concept:relatedto
freebase:relation_19.tsv	concept:musicianinmusicartist	concept:personbelongstoorganization concept:agentbelongstoorganization concept:subpartof _concept:agenthierarchicallyaboveagent concept:relatedto concept:agentcollaborateswithagent _concept:agentcontrols concept:agentinteractswithagent
freebase:relation_20.tsv	concept:newspaperincity	concept:agentactsinlocation concept:agentrelatedtolocation concept:atlocation concept:relatedto
freebase:relation_21.tsv	concept:politicianholdsoffice	concept:relatedto	concept:politicianusholdsoffice
freebase:relation_22.tsv	concept:producesproduct	concept:agentcreated concept:agentinvolvedwithitem concept:relatedto	concept:automakerproducesmodel
freebase:relation_23.tsv	concept:radiostationincity	concept:hasofficeincity concept:organizationactsinlocation concept:agentactsinlocation concept:agentrelatedtolocation concept:atlocation concept:relatedto
freebase:relation_24.tsv	concept:sportsgameloser	concept:sportsgameteam _concept:agentparticipatedinevent _concept:subpartof concept:relatedto
freebase:relation_25.tsv	concept:sportsgamesport	concept:relatedto
freebase:relation_26.tsv	concept:sportsgamewinner	concept:sportsgameteam _concept:agentparticipatedinevent _concept:subpartof concept:relatedto
freebase:relation_27.tsv	concept:sportusesequipment	concept:relatedto
freebase:relation_28.tsv	concept:sportusesstadium	concept:relatedto
freebase:relation_29.tsv	concept:stadiumlocatedincity	concept:attractionofcity concept:buildinglocatedincity _concept:proxyfor concept:locationlocatedwithinlocation concept:mutualproxyfor concept:subpartof concept:atlocation concept:relatedto
freebase:relation_30.tsv	concept:teamhomestadium	concept:organizationactsinlocation concept:agentactsinlocation concept:agentrelatedtolocation concept:atlocation concept:relatedto
freebase:relation_31.tsv	concept:teamplaysincity	_concept:proxyfor concept:organizationactsinlocation concept:mutualproxyfor concept:agentactsinlocation concept:relatedto concept:agentrelatedtolocation concept:atlocation
freebase:relation_32.tsv	concept:teamplaysinleague	concept:subpartoforganization concept:agentbelongstoorganization concept:subpartof _concept:agenthierarchicallyaboveagent concept:relatedto concept:agentcollaborateswithagent _concept:agentcontrols concept:agentinteractswithagent
freebase:relation_33.tsv	concept:teamplayssport	concept:relatedto
freebase:relation_34.tsv	concept:teamwontrophy	concept:relatedto
freebase:relation_35.tsv	concept:televisionstationaffiliatedwith	concept:subpartoforganization concept:agentbelongstoorganization concept:subpartof _concept:agenthierarchicallyaboveagent concept:relatedto concept:agentcollaborateswithagent _concept:agentcontrols concept:agentinteractswithagent
freebase:relation_36.tsv	concept:televisionstationincity	concept:hasofficeincity concept:organizationactsinlocation concept:agentactsinlocation concept:agentrelatedtolocation concept:atlocation concept:relatedto
freebase:relation_37.tsv	concept:visualartistartform	concept:relatedto
freebase:relation_38.tsv	concept:visualartistartmovement	concept:relatedto
freebase:relation_39.tsv	_concept:cityliesonriver	_concept:atlocation concept:relatedto
freebase:relation_40.tsv	concept:attractionofcity	concept:locationlocatedwithinlocation concept:subpartof concept:atlocation concept:relatedto	concept:zooincity concept:aquariumincity concept:transportationincity concept:parkincity concept:museumincity concept:stadiumlocatedincity
freebase:relation_41.tsv	concept:museumincity	concept:attractionofcity concept:buildinglocatedincity concept:locationlocatedwithinlocation concept:subpartof concept:atlocation concept:relatedto
freebase:relation_42.tsv	concept:zooincity	concept:attractionofcity concept:locationlocatedwithinlocation concept:subpartof concept:atlocation concept:relatedto
freebase:relation_43.tsv	concept:hotelincity	concept:buildinglocatedincity concept:locationlocatedwithinlocation concept:subpartof concept:atlocation concept:relatedto
freebase:relation_44.tsv	concept:restaurantincity	concept:buildinglocatedincity concept:locationlocatedwithinlocation concept:subpartof concept:atlocation concept:relatedto
freebase:relation_45.tsv	concept:universityincity _concept:cityuniversities	concept:organizationactsinlocation concept:agentactsinlocation concept:agentrelatedtolocation concept:atlocation concept:relatedto
freebase:relation_46.tsv	concept:hospitalincity	concept:buildinglocatedincity concept:locationlocatedwithinlocation concept:subpartof concept:atlocation concept:relatedto
freebase:relation_47.tsv	concept:languageofcountry	concept:relatedto
freebase:relation_48.tsv	concept:languageofcity	concept:relatedto
freebase:relation_49.tsv	concept:airportincity	concept:buildinglocatedincity concept:locationlocatedwithinlocation concept:subpartof concept:atlocation concept:relatedto
freebase:relation_50.tsv	concept:shoppingmallincity	concept:buildinglocatedincity concept:locationlocatedwithinlocation concept:subpartof concept:atlocation concept:relatedto
freebase:relation_51.tsv	concept:aquariumincity	concept:attractionofcity concept:locationlocatedwithinlocation concept:subpartof concept:atlocation concept:relatedto
freebase:relation_52.tsv	concept:transportationincity	concept:attractionofcity concept:locationlocatedwithinlocation concept:subpartof concept:atlocation concept:relatedto
freebase:relation_53.tsv	concept:professionistypeofprofession	_generalizations concept:specializationof concept:relatedto
freebase:relation_54.tsv	concept:academicprogramatuniversity	concept:relatedto
freebase:relation_55.tsv	concept:automakerproducesmodel	concept:producesproduct concept:agentcreated concept:agentinvolvedwithitem concept:relatedto
freebase:relation_56.tsv	concept:personbirthdate	concept:atdate concept:relatedto
freebase:relation_57.tsv	concept:persondeathdate	concept:atdate concept:relatedto
freebase:relation_58.tsv	concept:locationlocatedwithinlocation	concept:subpartof concept:atlocation concept:relatedto	concept:attractionofcity concept:farmlocatedincountry concept:citylocatedingeopoliticallocation concept:streetincity concept:mountaininstate concept:countrylocatedingeopoliticallocation concept:buildinglocatedincity concept:trainstationincity concept:statelocatedingeopoliticallocation concept:farmlocatedinstate concept:lakeinstate concept:zooincity concept:aquariumincity concept:transportationincity concept:parkincity concept:museumincity concept:stadiumlocatedincity concept:citylocatedincountry concept:citylocatedinstate concept:airportincity concept:restaurantincity concept:hospitalincity concept:shoppingmallincity concept:hotelincity concept:statelocatedincountry concept:citycapitalofcountry _concept:statehascapital _concept:cityhastrainstation
freebase:relation_59.tsv	concept:personhasresidenceinlocation	concept:agentactsinlocation concept:agentrelatedtolocation concept:atlocation concept:relatedto	concept:personmovedtostateorprovince concept:personhasresidenceingeopoliticallocation concept:personhasresidenceinstateorprovince concept:personhasresidenceincountry concept:personhasresidenceincity concept:malemovedtostateorprovince _concept:stateorprovinceresidenceofperson _concept:countryresidenceofperson _concept:cityresidenceofperson
freebase:relation_60.tsv	concept:personborninlocation	concept:agentactsinlocation concept:agentrelatedtolocation concept:atlocation concept:relatedto	concept:personwasborninstateorprovince concept:personbornincountry concept:personbornincity concept:writerwasbornincity _concept:stateorprovinceofpersonbirth _concept:countryofpersonbirth
freebase:relation_61.tsv	concept:personbornincity	concept:personborninlocation concept:agentactsinlocation concept:agentrelatedtolocation concept:atlocation concept:relatedto	concept:writerwasbornincity
freebase:relation_62.tsv	concept:parentofperson	concept:hasfamilymember concept:agentinteractswithagent concept:relatedto	concept:fatherofperson concept:motherofperson concept:biologicalfatherofperson concept:biologicalmotherofperson _concept:personhasbiologicalfather _concept:personhasbiologicalmother
freebase:relation_63.tsv	concept:motherofperson	concept:parentofperson concept:hasfamilymember concept:agentinteractswithagent concept:relatedto	concept:biologicalmotherofperson _concept:personhasbiologicalmother
freebase:relation_64.tsv	concept:fatherofperson	concept:parentofperson concept:hasfamilymember concept:agentinteractswithagent concept:relatedto	concept:biologicalfatherofperson _concept:personhasbiologicalfather
freebase:relation_65.tsv	concept:hassibling _concept:hassibling	concept:hasfamilymember concept:agentinteractswithagent concept:relatedto	_concept:hasbrother _concept:hassister concept:hassister concept:hasbrother
freebase:relation_66.tsv	concept:hasbrother	concept:hassibling concept:hasfamilymember concept:agentinteractswithagent concept:relatedto
freebase:relation_67.tsv	concept:hassister	concept:hassibling concept:hasfamilymember concept:agentinteractswithagent concept:relatedto
freebase:relation_68.tsv	concept:hasspouse _concept:hasspouse	concept:hasfamilymember concept:agentinteractswithagent concept:relatedto	concept:haswife _concept:haswife _concept:hashusband concept:hashusband
freebase:relation_69.tsv	concept:hashusband	concept:hasspouse concept:hasfamilymember concept:agentinteractswithagent concept:relatedto
freebase:relation_70.tsv	concept:haswife	concept:hasspouse concept:hasfamilymember concept:agentinteractswithagent concept:relatedto
freebase:relation_71.tsv	concept:personattendsschool	concept:personbelongstoorganization concept:agentbelongstoorganization concept:subpartof _concept:agenthierarchicallyaboveagent concept:relatedto concept:agentcollaborateswithagent _concept:agentcontrols concept:agentinteractswithagent	concept:persongraduatedschool concept:persongraduatedfromuniversity
freebase:relation_72.tsv	concept:politicianusholdsoffice	concept:politicianholdsoffice concept:relatedto
freebase:relation_73.tsv	concept:placeofworshippracticesreligion	_concept:atlocation concept:relatedto
freebase:relation_74.tsv	concept:agenthaswebsite	concept:agentrelatedtolocation concept:atlocation concept:relatedto	concept:organizationhasofficialwebsite _concept:officialwebsiteoforganization
freebase:relation_75.tsv	concept:drugpossiblytreatsphysiologicalcondition	concept:relatedto
freebase:relation_76.tsv	concept:drughassideeffect	concept:relatedto
freebase:relation_77.tsv	concept:organizationhiredperson	_concept:worksfor _concept:personbelongstoorganization _concept:agentbelongstoorganization _concept:subpartof concept:agenthierarchicallyaboveagent concept:relatedto concept:agentcollaborateswithagent concept:agentcontrols concept:agentinteractswithagent
freebase:relation_78.tsv	concept:persongraduatedschool	concept:personattendsschool concept:personbelongstoorganization concept:agentbelongstoorganization concept:subpartof _concept:agenthierarchicallyaboveagent concept:relatedto concept:agentcollaborateswithagent _concept:agentcontrols concept:agentinteractswithagent	concept:persongraduatedfromuniversity
freebase:relation_79.tsv	concept:wineryproduceswine	concept:agentinvolvedwithitem concept:relatedto
