-freebase:relation_9.tsv	/location/location/name:/location/citytown/name	/location/location/containedby:/location/country/name
-freebase:relation_10.tsv	/location/location/name:/location/citytown/name	/location/location/containedby:/location/us_state/name
freebase:relation_16.tsv	/sports/sports_league_participation/league	/sports/sports_league_participation/team:/sports/sports_team/arena_stadium
freebase:relation_21.tsv	/government/politician/name	/government/politician/government_positions_held:/government/government_position_held/:/government/government_position_held/office_position_or_title
freebase:relation_23.tsv	/broadcast/radio_station/name	/broadcast/radio_station/serves_area:/location/citytown/name
freebase:relation_25.tsv	/sports/sports_championship_event/name	/sports/sports_championship_event/champion:/sports/sports_team/sport
freebase:relation_29.tsv	/sports/sports_facility/name	/sports/sports_facility/name:/location/location/containedby:/location/citytown/name
freebase:relation_31.tsv	/sports/sports_team/name	/sports/sports_team/location:/location/citytown/name
freebase:relation_34.tsv	/sports/sports_team/name	/sports/sports_team/championships:/sports/sports_championship_event/championship
freebase:relation_35.tsv	/broadcast/tv_station/name	/broadcast/tv_station/affiliations:/broadcast/tv_affiliation_duration/network
freebase:relation_36.tsv	/broadcast/tv_station/name	/broadcast/tv_station/name:/broadcast/broadcast/area_served:/location/citytown/name
freebase:relation_40.tsv	/travel/tourist_attraction/name	/travel/tourist_attraction/near_travel_destination:/location/citytown/name
-freebase:relation_41.tsv	/architecture/museum/name	/architecture/museum/name:/location/location/name-/location/location/containedby:/location/citytown/name
-freebase:relation_42.tsv	/zoos/zoo/name	/zoos/zoo/name:/location/location/name-/location/location/containedby:/location/citytown/name
-freebase:relation_43.tsv	/travel/accommodation/name	/travel/accommodation/name:/location/location/name-/location/location/containedby:/location/citytown/name
freebase:relation_45.tsv	/education/university/name	/education/university/name:/education/educational_institution/name-/education/educational_institution/campuses:/location/location/name-/location/location/containedby:/location/citytown/name
-freebase:relation_46.tsv	/medicine/hospital/name	/medicine/hospital/name:/location/location/name-/location/location/containedby:/location/citytown/name
freebase:relation_48.tsv	/language/human_language/name	/language/human_language/region:/location/citytown/name
-freebase:relation_49.tsv	/aviation/airport/name	/aviation/airport/serves:/location/citytown/name
-freebase:relation_51.tsv	/zoos/zoo/name	/zoos/zoo/name:/location/location/name-/location/location/containedby:/location/citytown/name
-freebase:relation_52.tsv	/metropolitan_transit/transit_system/name	/metropolitan_transit/transit_system/area_served:/location/citytown/name
freebase:relation_54.tsv	/education/university/departments:/education/department/field	/education/university/name
freebase:relation_55.tsv	/automotive/company/name	/automotive/company/make_s:/automotive/make/model_s
-freebase:relation_61.tsv	/people/person/name	/people/person/place_of_birth:/location/citytown/name
freebase:relation_65.tsv	/people/person/name	/people/person/sibling_s:/people/sibling_relationship/sibling
freebase:relation_67.tsv	/people/person/name	/people/person/sibling_s:/people/sibling_relationship/sibling:/people/person/name
freebase:relation_68.tsv	/people/person/name	/people/person/spouse_s:/people/marriage/spouse
freebase:relation_69.tsv	/people/person/name	/people/person/spouse_s:/people/marriage/spouse:/people/person/name
freebase:relation_70.tsv	/people/person/name	/people/person/spouse_s:/people/marriage/spouse:/people/person/name
freebase:relation_71.tsv	/people/person/name	/people/person/education:/education/education/institution
freebase:relation_72.tsv	/government/politician/name	/government/politician/government_positions_held:/government/government_position_held/office_position_or_title
-freebase:relation_75.tsv	/medicine/drug/name	/medicine/drug/name:/medicine/medical_treatment/name-/medicine/medical_treatment/used_to_treat
-freebase:relation_76.tsv	/medicine/drug/name	/medicine/drug/name:/medicine/medical_treatment/name-/medicine/medical_treatment/side_effects
freebase:relation_77.tsv	/business/employer/name	/business/employer/employees:/business/employment_tenure/person
freebase:relation_78.tsv	/people/person/name	/people/person/education:/education/education/institution	/people/person/name-/people/person/education:/education/education/id-/education/education/degree:NOTNULL
